[
[0, 0, 0, 0, 0, 0, 0, 0, 0, 0, 0, 0, 0, 0, 0, 0, 0, 0, 0, 0, 0, 0, 0, 0, 0, 0, 0, 0, 0, 0, 0, 0, 0, 0, 0], 
[0, 0, 0, 0, 0, 0, 0, 0, 0, 0, 0, 0, 0, 0, 0, 0, 0, 0, 0, 0, 0, 0, 0, 0, 0, 0, 0, 0, 0, 0, 0, 0, 0, 0, 0], 
[0, 0, 0, 0, 0, 0, 0, 0, 0, 0, 0, 0, 0, 0, 0, 0, 0, 0, 0, 0, 0, 0, 0, 0, 0, 0, 0, 0, 0, 0, 0, 0, 0, 0, 0], 
[0, 0, 0, 0, 0, 0, 0, 0, 0, 0, 0, 0, 0, 0, 0, 0, 0, 0, 0, 0, 0, 0, 0, 0, 0, 0, 0, 0, 0, 0, 0, 0, 0, 0, 0], 
[0, 0, 0, 0, 0, 0, 0, 0, 0, 0, 0, 0, 0, 0, 2, 3, 3, 3, 4, 0, 0, 0, 0, 0, 0, 0, 0, 0, 0, 0, 0, 0, 0, 0, 0], 
[0, 0, 0, 0, 0, 0, 0, 0, 0, 0, 0, 0, 0, 0, 6, 7, 7, 7, 8, 0, 0, 0, 0, 0, 0, 0, 0, 0, 0, 0, 0, 0, 0, 0, 0], 
[0, 0, 0, 0, 0, 0, 0, 0, 2, 3, 3, 4, 0, 0, 6, 7, 7, 7, 8, 0, 0, 0, 0, 0, 0, 0, 0, 0, 0, 2, 3, 3, 3, 3, 3], 
[0, 0, 0, 0, 0, 0, 0, 0, 6, 7, 7, 8, 0, 0, 6, 7, 7, 7, 8, 0, 0, 0, 2, 3, 3, 3, 4, 0, 0, 6, 7, 7, 7, 7, 7], 
[3, 3, 3, 3, 4, 0, 0, 0, 6, 7, 7, 8, 0, 0, 6, 7, 7, 7, 8, 0, 0, 0, 6, 7, 7, 7, 8, 0, 0, 6, 7, 7, 7, 7, 7],
[7, 7, 7, 7, 8, 0, 0, 0, 6, 7, 7, 8, 0, 0, 6, 7, 7, 7, 8, 0, 0, 0, 6, 7, 7, 7, 8, 0, 0, 6, 7, 7, 7, 7, 7]
]